1111111
1000C01
10C0001
10P0001
10E0001
1111111
