1111111
1000P01
10C0001
11111E1
10C0001
1C000C1
1111111
